111111111111111
111111111111111
122222222222222
124666666666662
124363636363662
124222222222662
124246636443622
124263636643521
124246636443321
124222222222421
124666666666621
124232323232321
124666666666621
122222222222221
111111111111111