111111111111111
111111111111111
111111111111111
111111111111111
111122222211111
111226666221111
111263633621111
111244444421111
111263363621111
111222652221111
111112222111111
111111111111111
111111111111111
111111111111111
111111111111111