111111111111111
111111111111111
111111111111111
111111111111111
111111222222111
111222246652111
111266333662111
111242242242111
111266636662111
111266342622111
111222266621111
111111222221111
111111111111111
111111111111111
111111111111111