111111111111111
111111111111111
111111111111111
111111111111111
111111222222111
111222266662111
111266666652111
111242262262111
111266663662111
111263642622111
111222266621111
111111222221111
111111111111111
111111111111111
111111111111111