111111111111111
111111111111111
111111111111111
111122222221111
111126544421111
111126666622111
111222366662111
111266666662111
111263623262111
111266626662111
111222222222111
111111111111111
111111111111111
111111111111111
111111111111111