111111111111111
111111111111111
111111111111111
111111111111111
111122222111111
111126622211111
111125366211111
111222626221111
111242626621111
111243662621111
111246663621111
111222222221111
111111111111111
111111111111111
111111111111111